ハックリスト
============================

* jasmine: javascript のテストフレームワーク
* jenkins: jenksin
* Sphinx: 検索エンジン
* HAProxy: High Availability Load Balancing（高可用性プロキシー）
* Nginx: HTTPキャッシュサーバー
* Thrift: 言語バインディング用のフレームワーク
* Casandra: NoSQLの一つ
* Memcached: オンメモリキャッシュサーバー
* NSD: モダンなDNSコンテンツサーバー
* Unbound: モダンなDNSキャッシュサーバー
* autoconf: 自動化ビルドツール
* iptables: セキュリティソフト（ファイヤーウォール）
* apid: ファイル改竄検知ソフト
* capistrano: デプロイツール
* chef-solo: 運用自動化ツール
* zsh: 最強のbash
* php: php言語
* mysql: データベース
* emacs: エディター
* yacc: 構文解析器
* lex: 字句解析器
* gpref: hash構築ツール
* make: ビルドツール
* m4: プリプロセッサー
* Kerberos: セキュリティー認証ソフト（ケルベロス認証）
* redis: 非常に高速なKVS。様々なデータ構造をvalueに設定できる
* Pig: KVS。 Hadoopと連携して大規模分散処理が行える
* CouchDB: Erlangで書かれたDB
* mongoDB: NoSQLの一つ
* twitter Bootstrap: CSSを簡単に掛ける
* SELinux: Linuxのセキュリティモジュール
    ⇒ 使い方分からなくていつもdisabledしているので...


